50 61
0 -200
00 00 00 00 00 00 00 00 00 00 00 00 00 00 00 00 00 00 00 00 00 00 00 00 00 00 00 00 00 00 00 00 00 00 00 00 00 00 00 00 00 00 00 00 00 00 00 00 00 00
00 00 00 00 00 00 00 00 00 00 00 00 00 00 00 00 00 00 00 00 00 00 00 00 00 00 00 00 00 00 00 00 00 00 00 00 00 00 00 00 00 00 00 00 00 00 00 00 00 00
00 00 00 00 00 00 00 00 00 00 00 00 00 00 00 00 00 00 00 00 00 00 00 00 00 00 00 00 00 00 00 00 00 00 00 00 00 00 00 00 00 00 00 00 00 00 00 00 00 00
00 00 00 00 00 00 00 00 00 00 00 00 00 00 00 00 00 00 00 00 00 00 00 00 00 00 00 00 00 00 00 00 00 00 00 00 00 00 00 00 00 00 00 00 00 00 00 00 00 00
00 00 00 00 00 00 00 00 00 00 00 00 00 00 00 00 00 00 00 00 00 00 00 00 00 00 00 00 00 00 00 00 00 00 00 00 00 00 00 00 00 00 00 00 00 00 00 00 00 00
00 00 00 00 00 00 00 00 00 00 00 00 00 00 00 00 00 00 00 00 00 00 00 00 00 00 00 00 00 00 00 00 00 00 00 00 00 00 00 00 00 00 00 00 00 00 00 00 00 00
00 00 00 00 00 00 00 00 00 00 00 00 00 00 00 00 00 00 00 00 00 00 00 00 00 00 00 00 00 00 00 00 00 00 00 00 00 00 00 00 00 00 00 00 00 00 00 00 00 00
00 00 00 00 00 00 00 00 00 00 00 00 00 00 00 00 00 00 00 00 00 00 00 00 00 00 00 00 00 00 00 00 00 00 00 00 00 00 00 00 00 00 00 00 00 00 00 00 00 00
00 00 00 05 05 05 05 05 05 05 05 05 05 05 05 05 05 05 05 05 05 05 05 05 16 17 18 00 00 00 00 00 00 00 00 00 00 00 00 00 00 00 00 00 00 00 00 00 00 00
00 00 00 05 05 05 06 06 06 06 06 06 06 06 06 06 06 06 06 06 06 06 06 06 06 06 06 00 00 00 00 00 00 00 00 00 00 00 00 00 00 00 00 00 00 00 00 00 00 00
00 00 00 05 05 05 06 06 06 06 06 06 06 06 06 06 06 06 06 06 06 06 06 06 06 06 06 00 00 00 00 00 00 00 00 00 00 00 00 00 00 00 00 00 00 00 00 00 00 00
00 00 00 13 14 15 06 12 12 12 12 12 12 12 12 12 12 12 12 12 12 12 12 13 14 15 06 00 00 00 00 00 00 00 00 00 00 00 00 00 00 00 00 00 00 00 00 00 00 00
00 00 00 19 20 21 06 12 12 12 12 12 12 12 12 12 12 12 12 12 12 12 12 19 20 21 06 00 00 00 00 00 00 00 00 00 00 00 00 00 00 00 00 00 00 00 00 00 00 00
00 00 00 19 20 21 06 12 12 12 12 12 12 12 12 12 12 12 12 12 12 12 12 19 20 21 06 00 00 00 00 00 00 00 00 00 00 00 00 00 00 00 00 00 00 00 00 00 00 00
00 00 00 19 20 21 06 12 12 12 12 12 12 12 12 12 12 12 12 12 12 12 12 19 20 21 06 00 00 00 00 00 00 00 00 00 00 00 00 00 00 00 00 00 00 00 00 00 00 00
00 00 00 19 20 21 06 12 12 12 12 12 12 12 12 12 12 12 12 12 12 12 12 19 20 21 06 00 00 00 00 00 00 00 00 00 00 00 00 00 00 00 00 00 00 00 00 00 00 00
00 00 00 19 20 21 06 12 12 12 12 12 12 12 30 31 12 12 12 12 12 12 12 19 20 21 06 00 00 00 00 00 00 00 00 00 00 00 00 00 00 00 00 00 00 00 00 00 00 00
00 00 00 24 25 26 06 12 12 12 12 12 12 12 35 36 12 12 12 12 12 12 12 24 25 26 06 00 00 00 00 00 00 00 00 00 00 00 00 00 00 00 00 00 00 00 00 00 00 00
00 00 00 05 05 05 06 05 05 05 05 05 05 05 05 05 05 05 05 05 05 05 05 05 05 05 06 00 00 00 00 00 00 00 00 00 00 00 00 00 00 00 00 00 00 00 00 00 00 00
00 00 00 05 05 05 06 06 06 06 06 06 06 06 06 06 06 06 06 06 06 06 06 06 06 06 06 00 00 00 00 00 00 00 00 00 00 00 00 00 00 00 00 00 00 00 00 00 00 00
00 00 00 05 05 05 06 06 06 06 06 06 06 06 06 06 06 06 06 06 06 06 06 06 06 06 06 00 00 00 00 00 00 00 00 00 00 00 00 00 00 00 00 00 00 00 00 00 00 00
00 00 00 13 14 15 06 12 12 12 12 12 12 12 12 12 12 12 12 12 12 12 12 13 14 15 06 00 00 00 00 00 00 00 00 00 00 00 00 00 00 00 00 00 00 00 00 00 00 00
00 00 00 19 20 21 06 12 12 12 12 12 12 12 12 12 12 12 12 12 12 12 12 19 20 21 06 00 00 00 00 00 00 00 00 00 00 00 00 00 00 00 00 00 00 00 00 00 00 00
00 00 00 19 20 21 06 12 12 12 12 12 12 12 12 12 12 12 12 12 12 12 12 19 20 21 06 00 00 00 00 00 00 00 00 00 00 00 00 00 00 00 00 00 00 00 00 00 00 00
00 00 00 19 20 21 06 12 12 12 12 12 12 12 12 12 12 12 12 12 12 12 12 19 20 21 06 00 00 00 00 00 00 00 00 00 00 00 00 00 00 00 00 00 00 00 00 00 00 00
00 00 00 19 20 21 06 12 12 12 12 12 12 12 12 12 12 12 12 12 12 12 12 19 20 21 06 00 00 00 00 00 00 00 00 00 00 00 00 00 00 00 00 00 00 00 00 00 00 00
00 00 00 19 20 21 06 12 12 12 12 12 12 12 22 23 12 12 12 12 12 12 12 19 20 21 06 00 00 00 00 00 00 00 00 00 00 00 00 00 00 00 00 00 00 00 00 00 00 00
00 00 00 24 25 26 06 12 12 12 12 12 12 12 35 36 12 12 12 12 12 12 12 24 25 26 06 00 00 00 00 00 00 00 00 00 00 00 00 00 00 00 00 00 00 00 00 00 00 00
00 00 00 05 05 05 06 05 05 05 05 05 05 05 05 05 05 05 05 05 05 05 05 05 05 05 06 00 00 00 00 00 00 00 00 00 00 00 00 00 00 00 00 00 00 00 00 00 00 00
00 00 00 05 05 05 06 06 06 06 06 06 06 06 06 06 06 06 06 06 06 06 06 06 06 06 06 00 00 00 00 00 00 00 00 00 00 00 00 00 00 00 00 00 00 00 00 00 00 00
00 00 00 05 05 05 06 06 06 06 06 06 06 06 06 06 06 06 06 06 06 06 06 06 06 06 06 00 00 00 00 00 00 00 00 00 00 00 00 00 00 00 00 00 00 00 00 00 00 00
00 00 00 13 14 15 06 12 12 12 12 12 12 12 12 12 12 12 12 12 12 12 12 05 05 05 06 00 00 00 00 00 00 00 00 00 00 00 00 00 00 00 00 00 00 00 00 00 00 00
00 00 00 19 20 21 06 12 12 12 12 12 12 12 12 12 12 12 12 12 12 12 12 05 05 05 06 00 00 00 00 00 00 00 00 00 00 00 00 00 00 00 00 00 00 00 00 00 00 00
00 00 00 19 20 21 06 12 12 12 12 12 12 12 12 12 12 12 12 12 12 12 12 05 05 05 06 00 00 00 00 00 00 00 00 00 00 00 00 00 00 00 00 00 00 00 00 00 00 00
00 00 00 19 20 21 06 12 12 12 12 12 12 12 12 12 12 12 12 12 12 12 12 05 05 05 06 00 00 00 00 00 00 00 00 00 00 00 00 00 00 00 00 00 00 00 00 00 00 00
00 00 00 19 20 21 06 12 12 12 12 12 12 12 12 12 12 12 12 12 12 12 12 05 05 05 06 00 00 00 00 00 00 00 00 00 00 00 00 00 00 00 00 00 00 00 00 00 00 00
00 00 00 19 20 21 06 12 12 12 12 12 12 12 22 23 12 12 12 12 12 12 12 32 33 05 06 00 00 00 00 00 00 00 00 00 00 00 00 00 00 00 00 00 00 00 00 00 00 00
00 00 00 24 25 26 06 12 12 12 12 12 12 12 35 36 12 12 12 12 12 12 12 37 38 05 06 00 00 00 00 00 00 00 00 00 00 00 00 00 00 00 00 00 00 00 00 00 00 00
00 00 00 05 05 05 06 05 05 05 05 05 05 05 05 05 05 05 05 05 05 05 05 40 41 05 06 05 05 05 05 05 05 05 05 05 05 05 05 05 05 05 05 05 16 17 18 00 00 00
00 00 00 05 05 05 06 06 06 06 06 06 06 06 06 06 06 06 06 06 06 06 06 06 06 06 06 06 06 06 06 06 06 06 06 06 06 06 06 06 06 06 06 06 06 06 06 00 00 00
00 00 00 05 05 05 06 06 06 06 06 06 06 06 06 06 06 06 06 06 06 06 06 06 06 06 06 06 06 06 06 06 06 06 06 06 06 06 06 06 06 06 06 06 06 06 06 00 00 00
00 00 00 13 14 15 06 12 12 12 12 12 12 12 12 12 12 12 12 12 12 12 12 12 12 12 12 12 12 12 12 12 12 12 12 12 12 12 12 12 12 12 12 13 14 15 06 00 00 00
00 00 00 19 20 21 06 12 12 12 12 12 12 12 12 12 12 12 12 12 12 12 12 12 12 12 12 12 12 12 12 12 12 12 12 12 12 12 12 12 12 12 12 19 20 21 06 00 00 00
00 00 00 19 20 21 06 12 12 12 12 12 12 12 12 12 12 12 12 12 12 12 12 12 12 12 12 12 12 12 12 12 12 12 12 12 12 12 12 12 12 12 12 19 20 21 06 00 00 00
00 00 00 19 20 21 06 12 12 12 12 12 12 12 12 12 12 12 12 12 12 12 12 12 12 12 12 12 12 12 12 12 12 12 12 12 12 12 12 12 12 12 12 19 20 21 06 00 00 00
00 00 00 19 20 21 06 12 12 12 12 12 12 12 12 12 12 12 12 12 12 12 12 12 12 12 12 12 12 12 12 12 12 12 12 12 12 12 12 12 12 12 12 19 20 21 06 00 00 00
00 00 00 19 20 21 06 12 12 12 12 12 12 12 22 23 12 12 12 12 12 12 12 12 12 12 12 12 12 12 12 12 12 12 30 31 12 12 12 12 12 12 12 19 20 21 06 00 00 00
00 00 00 24 25 26 06 12 12 12 12 12 12 12 35 36 12 12 12 12 12 12 12 12 12 12 12 12 12 12 12 12 12 12 35 36 12 12 12 12 12 12 12 24 25 26 06 00 00 00
00 00 00 05 05 05 06 05 05 05 05 05 05 05 05 05 05 05 05 05 05 05 05 05 05 05 05 05 05 05 05 05 05 05 05 05 05 05 05 05 05 05 05 05 05 05 06 00 00 00
00 00 00 05 05 05 06 06 06 06 06 06 06 06 06 06 06 06 06 06 06 06 06 06 06 06 06 06 06 06 06 06 06 06 06 06 06 06 06 06 06 06 06 06 06 06 06 00 00 00
00 00 00 05 05 05 06 06 06 06 06 06 06 06 06 06 06 06 06 06 06 06 06 06 06 06 06 06 06 06 06 06 06 06 06 06 06 06 06 06 06 06 06 06 06 06 06 00 00 00
00 00 00 05 05 05 06 12 12 12 12 12 12 12 12 12 12 12 12 12 12 12 12 05 05 05 06 12 12 12 12 12 12 12 12 12 12 12 12 12 12 12 12 05 05 05 06 00 00 00
00 00 00 05 05 05 06 12 12 12 12 12 12 12 12 12 12 12 12 12 12 12 12 05 05 05 06 12 12 12 12 12 12 12 12 12 12 12 12 12 12 12 12 05 05 05 06 00 00 00
00 00 00 05 05 05 06 12 12 12 12 12 12 12 12 12 12 12 12 12 12 12 12 05 05 05 06 12 12 12 12 12 12 12 12 12 12 12 12 12 12 12 12 05 05 05 06 00 00 00
00 00 00 05 05 05 06 12 12 12 12 12 12 12 12 12 12 12 12 12 12 12 12 05 05 05 06 12 12 12 12 12 12 12 12 12 12 12 12 12 12 12 12 05 05 05 06 00 00 00
00 00 00 05 05 05 06 12 12 12 12 12 12 12 12 12 12 12 12 12 12 12 12 05 05 05 06 12 12 12 12 12 12 12 12 12 12 12 12 12 12 12 12 05 05 05 06 00 00 00
00 00 00 32 33 05 06 12 12 12 12 12 12 12 12 12 12 12 12 12 12 12 12 32 33 05 06 12 12 12 12 12 12 12 22 23 12 12 12 12 12 12 12 32 33 05 06 00 00 00
00 00 00 37 38 05 06 12 12 12 12 12 12 12 12 12 12 12 12 12 12 12 12 37 38 05 06 12 12 12 12 12 12 12 35 36 12 12 12 12 12 12 12 37 38 05 06 00 00 00
00 00 00 40 41 05 06 05 05 05 05 05 05 05 05 05 05 05 05 05 05 05 05 40 41 05 06 05 05 05 05 05 05 05 05 05 05 05 05 05 05 05 05 40 41 05 06 00 00 00
00 00 00 27 28 29 06 06 06 06 06 06 06 06 06 06 06 06 06 06 06 06 06 06 06 06 06 06 06 06 06 06 06 06 06 06 06 06 06 06 06 06 06 06 06 06 06 00 00 00
45 42 42 42 42 42 42 42 42 42 42 42 42 42 42 42 42 42 42 42 42 42 42 42 42 42 42 42 42 42 42 42 42 42 42 42 42 42 42 42 42 42 42 42 42 42 42 42 42 43